%%%%%%%%%%%%%%%%%%%%
%o   %        %   .%
% %% % %%%%%% % %% %
% %              % %
% % %% %%  %% %% % %
%      %    %    . %
% % %% %%%%%% %% % %
% %.      .      % %
% %% % %%%%%% % %% %
%    %   P    %   o%
%%%%%%%%%%%%%%%%%%%%
