%%%%%%%%%%%%%%%%%%%%
%.   %        %   .%
% %% % %%%%%% % %% %
% %              % %
% % %% %%  %% %% % %
%      %    %    . %
% % %% %%%%%% %% % %
% %.      .      % %
% %% % %%%%%% % %% %
%    %   P    %   .%
%%%%%%%%%%%%%%%%%%%%
