%%%%%%%%%%%%%%%%%%%%%%%%%%%%%%%%%%%%%
%       % % %           %   %     % %
%       % % %           %   %     % %
%       % % %           %   %     % %
%       % % %           %   %     % %
% %%%%%%% % %%% % %%% %%% %%%%%%% % %
% %%%%%%% % %%% % %%% %%% %%%%%%% % %
% %%%%%%% % %%% % %%% %%% %%%%%%% % %
% %%%%%%% % %%% % %%% %%% %%%%%%% % %
%       %       % %     %     % %   %
%       %       % %     %     % %   %
%       %       % %     %     % %   %
%       %       % %     %     % %   %
%%%%% %%%%% %%% % % % %%% %%%%% % %%%
%%%%% %%%%% %%% % % % %%% %%%%% % %%%
%%%%% %%%%% %%% % % % %%% %%%%% % %%%
%%%%% %%%%% %%% % % % %%% %%%%% % %%%
%   % % % %   % % % %   % %   % %   %
%   % % % %   % % % %   % %   % %   %
%   % % % %   % % % %   % %   % %   %
%   % % % %   % % % %   % %   % %   %
% %%% % % % %%% %%%%% %%% % %%% %%% %
% %%% % % % %%% %%%%% %%% % %%% %%% %
% %%% % % % %%% %%%%% %%% % %%% %%% %
% %%% % % % %%% %%%%% %%% % %%% %%% %
%       %     %   %   %     % % %   %
%       %     %   %   %     % % %   %
%       %     %   %   %     % % %   %
%       %     %   %   %     % % %   %
%%% %%%%%%%%% %%%%%%% %%% %%% % % % %
%%% %%%%%%%%% %%%%%%% %%% %%% % % % %
%%% %%%%%%%%% %%%%%%% %%% %%% % % % %
%%% %%%%%%%%% %%%%%%% %%% %%% % % % %
%             %       % %   %     % %
%             %       % %   %     % %
%             %       % %   %     % %
%             %       % %   %     % %
% % %%%%% % %%% % % %%% % %%% %%% % %
% % %%%%% % %%% % % %%% % %%% %%% % %
% % %%%%% % %%% % % %%% % %%% %%% % %
% % %%%%% % %%% % % %%% % %%% %%% % %
% % %     % % % % %     %   % % % % %
% % %     % % % % %     %   % % % % %
% % %     % % % % %     %   % % % % %
% % %     % % % % %     %   % % % % %
% % % %%%%%%% % %%%%%%%%% %%% % %%% %
% % % %%%%%%% % %%%%%%%%% %%% % %%% %
% % % %%%%%%% % %%%%%%%%% %%% % %%% %
% % % %%%%%%% % %%%%%%%%% %%% % %%% %
% % % %     %   %     %     %   %   %
% % % %     %   %     %     %   %   %
% % % %     %   %     %     %   %   %
% % % %     %   %     %     %   %   %
%%% %%% % %%%%% %%%%% %%% %%% %%%%% %
%%% %%% % %%%%% %%%%% %%% %%% %%%%% %
%%% %%% % %%%%% %%%%% %%% %%% %%%%% %
%%% %%% % %%%%% %%%%% %%% %%% %%%%% %
%     % % %     % %     % %   % % % %
%     % % %     % %     % %   % % % %
%     % % %     % %     % %   % % % %
%     % % %     % %     % %   % % % %
% % % % % %%% %%% %%% %%% % % % % % %
% % % % % %%% %%% %%% %%% % % % % % %
% % % % % %%% %%% %%% %%% % % % % % %
% % % % % %%% %%% %%% %%% % % % % % %
% % % % %                 % % %     %
% % % % %                 % % %     %
% % % % %                 % % %     %
% % % % %                 % % %     %
%%% %%%%%%% % % %%%%% %%% % %%% %%%%%
%%% %%%%%%% % % %%%%% %%% % %%% %%%%%
%%% %%%%%%% % % %%%%% %%% % %%% %%%%%
%%% %%%%%%% % % %%%%% %%% % %%% %%%%%
%       % % % %     %   %     % %   %
%       % % % %     %   %     % %   %
%       % % % %     %   %     % %   %
%       % % % %     %   %     % %   %
%%%%% % % %%%%%%%%% %%%%%%%%%%% % %%%
%%%%% % % %%%%%%%%% %%%%%%%%%%% % %%%
%%%%% % % %%%%%%%%% %%%%%%%%%%% % %%%
%%%%% % % %%%%%%%%% %%%%%%%%%%% % %%%
%   % %           % %     %   % %   %
%   % %           % %     %   % %   %
%   % %           % %     %   % %   %
%   % %           % %     %   % %   %
% %%% %%%%% %%%%%%%%% %%%%% % % %%% %
% %%% %%%%% %%%%%%%%% %%%%% % % %%% %
% %%% %%%%% %%%%%%%%% %%%%% % % %%% %
% %%% %%%%% %%%%%%%%% %%%%% % % %%% %
% %   %      %        %     %       %
% %   %      %        %     %       %
% %   %      %        %     %       %
% %   %      %        %     %       %
% % % %%%%% %%% % % % % %%%%%%%%%%%%%
% % % %%%%% %%% % % % % %%%%%%%%%%%%%
% % % %%%%% %%% % % % % %%%%%%%%%%%%%
% % % %%%%% %%% % % % % %%%%%%%%%%%%%
% % %   %     % % % %       %   % % %
% % %   %     % % % %       %   % % %
% % %   %     % % % %       %   % % %
% % %   %     % % % %       %   % % %
% % %%% %%% % % % %%%%%%%%% %%% % % %
% % %%% %%% % % % %%%%%%%%% %%% % % %
% % %%% %%% % % % %%%%%%%%% %%% % % %
% % %%% %%% % % % %%%%%%%%% %%% % % %
% %   % %   % % %   % %   % % %     %
% %   % %   % % %   % %   % % %     %
% %   % %   % % %   % %   % % %     %
% %   % %   % % %   % %   % % %     %
% %%% %%% %%%%% %%% % % %%%%% % %%%%%
% %%% %%% %%%%% %%% % % %%%%% % %%%%%
% %%% %%% %%%%% %%% % % %%%%% % %%%%%
% %%% %%% %%%%% %%% % % %%%%% % %%%%%
%       %   %     % %     %   % %   %
%       %   %     % %     %   % %   %
%       %   %     % %     %   % %   %
%       %   %     % %     %   % %   %
%%% % %%%%% %%%%% %%% %%% % %%% % %%%
%%% % %%%%% %%%%% %%% %%% % %%% % %%%
%%% % %%%%% %%%%% %%% %%% % %%% % %%%
%%% % %%%%% %%%%% %%% %%% % %%% % %%%
% % % % % % % %     % %   % %   % % %
% % % % % % % %     % %   % %   % % %
% % % % % % % %     % %   % %   % % %
% % % % % % % %     % %   % %   % % %
% % %%% % % % % %%%%%%%%% % % % % % %
% % %%% % % % % %%%%%%%%% % % % % % %
% % %%% % % % % %%%%%%%%% % % % % % %
% % %%% % % % % %%%%%%%%% % % % % % %
%   %   %   %                 %     %
%   %   %   %                 %     %
%   %   %   %                 %     %
%   %   %   %                 %     %
% % % % %%% %%% %%%%%%% %%% %%% %%% %
% % % % %%% %%% %%%%%%% %%% %%% %%% %
% % % % %%% %%% %%%%%%% %%% %%% %%% %
% % % % %%% %%% %%%%%%% %%% %%% %%% %
%.% % %       %   %       %   % %  P%
%%%%%%%%%%%%%%%%%%%%%%%%%%%%%%%%%%%%%